###############
#     @       #
#             #
#             #
#             #
#             #
#             #
#             #
#             #
#             #
#             #
#       x     #
#             #
#             #
###############
