###############
#      e    oi#
#    b r b  ###
# #    a    ###
# #   #b#   #x#
# #    b    # #
#o#   #b#   # #
#*#   bbb   # #
#a#    b    # #
###   bbb   # #
#h            #
#h   2   1    #
######   ######
#io    @    oi#
###############
