###############
#      @      #
#     o*o  b  #
#h    *#*    h#
#h    o*o    h#
#h b         h#
#h           h#
#ooooo     ooo#
#orboo     o  #
#*aboo     o e#
#aaaoo     o  #
#ooooo     ooo#
#ooooo        #
#x   h   v   *#
###############
